stateDiagram-v2
    [*] --> ПолучениеДокумента

    ПолучениеДокумента --> ПервичнаяОбработкаДокумента
    ПервичнаяОбработкаДокумента --> СканированиеДокумента: при необходимости
    СканированиеДокумента --> РегистрацияВЖурнале

    РегистрацияВЖурнале --> ТребуетсяРезолюция

    state ТребуетсяРезолюция <<choice>>
    ТребуетсяРезолюция --> ПередачаРуководителю: да
    ТребуетсяРезолюция --> ОпределениеИсполнителей: нет

    ПередачаРуководителю --> ОжиданиеРезолюции
    ОжиданиеРезолюции --> ПолучениеРезолюции
    ПолучениеРезолюции --> ВнесениеРезолюции
    ВнесениеРезолюции --> ОпределениеИсполнителей

    ОпределениеИсполнителей --> ПередачаДокументаИсполнителям
    ПередачаДокументаИсполнителям --> ПостановкаНаКонтроль

    ПостановкаНаКонтроль --> ТребуетсяОтвет

    state ТребуетсяОтвет <<choice>>
    ТребуетсяОтвет --> УстановкаСрокаИсполнения: да
    ТребуетсяОтвет --> ОповещениеИсполнителей: нет

    УстановкаСрокаИсполнения --> ОповещениеИсполнителей

    ОповещениеИсполнителей --> КонтрольИсполнения
    КонтрольИсполнения --> ПолучениеОтчетаОбИсполнении

    ПолучениеОтчетаОбИсполнении --> ДокументИсполнен

    state ДокументИсполнен <<choice>>
    ДокументИсполнен --> СнятиеСКонтроля: да
    ДокументИсполнен --> ОтправкаНапоминания: нет

    ОтправкаНапоминания --> УведомлениеРуководителя
    УведомлениеРуководителя --> ОжиданиеИсполнения
    ОжиданиеИсполнения --> ПолучениеОтчетаОбИсполнении

    СнятиеСКонтроля --> ПеремещениеВАрхив
    ПеремещениеВАрхив --> [*]

    note right of ПолучениеДокумента: Доставка почты,<br>электронная почта,<br>передача курьером
    note right of СканированиеДокумента: Создание электронной<br>копии для хранения<br>в системе
    note right of РегистрацияВЖурнале: Присвоение номера,<br>создание карточки<br>документа
    note left of ОпределениеИсполнителей: На основе резолюции<br>или типа документа
    note right of КонтрольИсполнения: Мониторинг сроков,<br>периодические<br>проверки статуса